++++++++++++++++++++++
+   +   ++ ++        +
  S   +     ++++++++++
+ +    ++  ++++ +++ ++
+ +   + + ++    +++  +
+          ++  ++  + +
+++++ + +      ++  + +
+++++ +++  + +  ++   +
+          + +  + +  +
+++++ +  + + +     + +
++++++++++++++++++++++